WWWWWWWWWWWWWWWWWWWWWWWWWWWWWWWWWWWWWWWW
W             M                        W
W   M                                  W
W                               M      W
W                    Q                 W
W         WWWWWWW         WWWWW        W
W        WWWWWWWW      WWWWWWWW        W
W         WWWWWWWWWWWWWWWWWWWWWWW      W
WWWWWWWWWWWWWWWWWWWWWWWWWWWWWWWWWWWWWWWW